1 1 1 1 1 1 1 1 1 1 1 1 1 1 1 1 1 1 1 1 1 1 1 1
1 0 0 0 0 0 0 0 0 0 0 0 0 0 0 0 0 0 0 0 0 0 0 1
1 0 0 0 0 0 0 0 0 0 0 0 0 0 0 0 0 0 0 0 0 0 0 1
1 0 0 0 0 0 0 0 0 0 0 0 0 0 0 0 0 6 6 6 6 0 0 1
1 0 0 0 0 0 3 3 8 3 3 0 0 0 0 0 0 5 0 0 6 0 0 1
1 0 0 0 0 0 3 0 0 0 3 0 0 7 7 7 5 5 0 0 4 0 0 1
1 0 0 0 0 0 3 0 0 0 3 0 0 7 0 0 0 0 0 0 0 0 0 1
1 0 0 0 0 0 3 0 0 0 3 0 0 4 0 0 0 0 0 0 4 0 0 1
1 0 0 0 0 0 3 3 0 3 3 0 0 4 0 0 0 0 0 0 4 0 0 1
1 0 0 0 0 0 0 0 0 0 0 0 0 7 0 0 6 0 0 0 5 0 0 1
1 0 0 0 4 4 0 0 0 0 0 0 0 7 0 0 6 0 0 6 6 0 0 1
1 0 0 0 0 4 0 0 0 0 7 7 7 0 0 0 4 0 0 0 0 0 0 1
1 0 0 0 0 4 0 0 0 0 7 0 0 0 0 0 4 0 0 0 0 0 0 1
1 0 0 0 6 4 0 0 0 0 0 0 0 0 0 0 0 0 0 0 0 0 0 1
1 0 0 0 0 4 0 0 0 0 0 0 5 5 0 0 0 0 0 0 0 0 0 1
1 0 0 0 0 0 0 0 0 6 5 5 5 0 0 0 0 0 0 0 0 0 0 1
1 0 4 4 4 0 0 0 0 6 0 0 0 0 0 5 6 5 5 4 0 0 0 1
1 0 0 0 0 0 0 0 0 6 0 0 0 0 0 5 0 3 0 6 0 0 0 1
1 0 0 0 0 0 0 0 0 6 0 0 4 0 0 6 0 0 0 5 0 0 0 1
1 0 3 3 0 0 0 0 0 0 0 0 4 0 0 6 0 0 0 6 0 0 0 1
1 0 0 0 0 0 0 0 0 0 0 0 7 0 0 0 0 0 0 0 0 0 0 1
1 0 0 0 0 3 0 0 0 0 0 0 5 0 0 0 0 0 0 0 0 0 0 1
1 0 0 0 0 3 0 0 0 0 0 0 5 5 5 5 5 5 5 5 0 0 0 1
1 1 1 1 1 1 1 1 1 1 1 1 1 1 1 1 1 1 1 1 1 1 1 1
